###############
#S# #     #   #
# # # # # ### #
# #   # #   # #
# ### # ### # #
#   # # #     #
### # # ##### #
#   # #     # #
# ### ##### ###
#   # #   #   #
### # # ##### #
# # #   #   # #
# # ##### # # #
#         #  E#
###############
